rows 27
cols 35
players 2
island $ 0
island $ 0
island $ 0
zone rect 0 0 7 11
zone rect -8 -12 -1 -1

m ...................................
m ........a..........................
m ......a............................
m ....a..............................
m ..a...........................$....
m ...................................
m ...................................
m ...................................
m ...................................
m ...................................
m ...................................
m ...................................
m ...................................
m .................$.................
m ...................................
m ...................................
m ...................................
m ...................................
m ...................................
m ...................................
m ...................................
m ...................................
m ....$...........................b..
m ..............................b....
m ............................b......
m ..........................b........
m ...................................