rows 29
cols 29
players 2
island $ 0 2 20
zone radius 15 0 49
zone radius 15 -1 49


m .............................
m .............................
m .............................
m .............................
m .............................
m .............................
m .............................
m .............................
m .............................
m .............................
m .............................
m .............................
m a...........................b
m .a.........................b.
m ..a...........$...........b..
m .a.........................b.
m a...........................b
m .............................
m .............................
m .............................
m .............................
m .............................
m .............................
m .............................
m .............................
m .............................
m .............................
m .............................
m .............................