rows 35
cols 41
players 2
island $ 0
island $ 0
island $ 0 2 30
island $ 0
island $ 0
zone radius -3 4 37
zone radius 2 -5 37


m ....................................b....
m ........................................b
m ...................................b..b..
m ....................................b....
m ................$.................b......
m .........................................
m .........................................
m .........................................
m .........................................
m .........................................
m ....$....................................
m .........................................
m .........................................
m .........................................
m .........................................
m .........................................
m .........................................
m ....................$....................
m .........................................
m .........................................
m .........................................
m .........................................
m .........................................
m .........................................
m ....................................$....
m .........................................
m .........................................
m .........................................
m .........................................
m .........................................
m ......a.................$................
m ....a....................................
m ..a..a...................................
m a........................................
m ....a....................................
