rows 35
cols 35
players 2
island $ 0
island $ 0
island $ 0
island $ 0
island $ 0
zone 0 radius 8 -5 37
zone 1 radius -9 -5 37

m ...................................
m ...................................
m ...................................
m ...................................
m ...................$...............
m ...................................
m ............................a......
m .............................a.....
m .......$......................a..a.
m ...............................a...
m .............................a.....
m ...................................
m ...................................
m ...................................
m ...................................
m ...................................
m ...................................
m ....$..............................
m ...................................
m ...................................
m ...................................
m ...................................
m ...................................
m ...................................
m .............................b.....
m ...............................b...
m .......$......................b..b.
m .............................b.....
m ............................b......
m ...................................
m ...................$...............
m ...................................
m ...................................
m ...................................
m ...................................
