rows 41
cols 41
players 2
island $ 0
island $ 0
island $ 0
island $ 0
island $ 0
zone 0 rect 0 0 5 12
zone 1 rect 0 -13 5 -1
zone 0 rect -5 -5 -1 -1
zone 1 rect -5 0 -1 4

m .........................................
m ...a.a.a.a.....................b.b.b.b...
m ....a.a.a...........$...........b.b.b....
m .........................................
m .........................................
m .........................................
m .........................................
m .........................................
m .........................................
m .........................................
m .........................................
m .........................................
m .........................................
m .........................................
m .........................................
m .........................................
m .........................................
m .........................................
m .........................................
m .........................................
m .........................................
m .........................................
m .........................................
m .........................................
m .........................................
m .........................................
m .........................................
m .........................................
m ....................$....................
m .........................................
m .........................................
m .........................................
m .........................................
m ....$...............................$....
m .........................................
m .........................................
m .........................................
m .........................................
m ....................$....................
m .b.....................................a.
m .........................................
