rows 41
cols 41
players 2
island $ 0
island $ 0
island $ 0
island $ 0
island $ 0

m .........................................
m ......a......b......a......b......a......
m .........................................
m .........................................
m .........................................
m .........................................
m .b.....................................b.
m .........................................
m .........................................
m .........................................
m .........................................
m .........................................
m .........................................
m .a...........$.............$...........a.
m .........................................
m .........................................
m .........................................
m .........................................
m .........................................
m .........................................
m .b..................$..................b.
m .........................................
m .........................................
m .........................................
m .........................................
m .........................................
m .........................................
m .a...........$.............$...........a.
m .........................................
m .........................................
m .........................................
m .........................................
m .........................................
m .........................................
m .b.....................................b.
m .........................................
m .........................................
m .........................................
m .........................................
m ......a......b......a......b......a......
m .........................................
