rows 21
cols 21
players 2
island $ 0
zone 0 rect 0 0 4 4
zone 0 rect -5 -5 -1 -1
zone 1 rect 0 -5 4 -1
zone 1 rect -5 0 -1 4
spawnturns 20
ghostcooldown 30
maxpoints 100


m .....................
m .a.................b.
m .....................
m .....................
m .....................
m .....................
m .....................
m .....................
m .....................
m .....................
m ..........$..........
m .....................
m .....................
m .....................
m .....................
m .....................
m .....................
m .....................
m .....................
m .b.................a.
m .....................
