rows 27
cols 35
players 2
island $ 0
island $ 0
island $ 0
island $ 0
zone 0 rect 8 9 18 16
zone 1 rect 8 18 18 25

m ...................................
m ...................................
m ................................$..
m ...................................
m ...................................
m ...................................
m ...................................
m ........$..........................
m ...................................
m ...................................
m ...................................
m .............a.......b.............
m ...................................
m ............aa.......bb............
m ...................................
m .............a.......b.............
m ...................................
m ...................................
m ...................................
m ..........................$........
m ...................................
m ...................................
m ...................................
m ...................................
m ..$................................
m ...................................
m ...................................