rows 41
cols 41
players 2
island $ 0
island $ 0
island $ 0
island $ 0
island $ 0
zone 0 rect 0 7 6 19
zone 1 rect 7 0 19 6

m .........................................
m ..........a.a.a.a........................
m ...........a.a.a.........................
m ............a.a.......................$..
m .........................................
m .........................................
m .........................................
m .........................................
m .........................................
m .........................................
m .b.......................................
m ..b......................................
m .b.b........$............................
m ..b......................................
m .b.b.....................................
m ..b......................................
m .b..............................$........
m .........................................
m .........................................
m .........................................
m .........................................
m .........................................
m .........................................
m .........................................
m .........................................
m .........................................
m .........................................
m .........................................
m .........................................
m .........................................
m .........................................
m .........................................
m ................$........................
m .........................................
m .........................................
m .........................................
m .........................................
m .........................................
m ...$.....................................
m .........................................
m .........................................
