rows 32
cols 35
players 2
island $ 0 2 30
island $ 0 1 20
island $ 0 1 20
island $ 0 2 20
zone 0 radius 24 6 26
zone 1 radius 24 28 26

m ...................................
m ...................................
m ...................................
m ...................................
m .................$.................
m ...................................
m ...................................
m ...................................
m ...................................
m ...................................
m .............$.......$.............
m ...................................
m ...................................
m ...................................
m ...................................
m ...................................
m ...................................
m ...................................
m ...................................
m ...................................
m ...................................
m ...................................
m ......a.....................b......
m ...................................
m .....a.......................b.....
m ...................................
m ....a.a.a........$........b.b.b....
m ...................................
m ...................................
m ...................................
m ...................................
m ...................................


























