rows 27
cols 35
players 2
island $ 0
island $ 0 2 20
island $ 0
zone 0 radius 16 13 10
zone 1 radius 10 21 10
zone 0 radius 2 32 32
zone 1 radius 24 2 32

m ...................................
m ..............................a..a.
m ................................a..
m ...................................
m ....$............................a.
m ...................................
m ...................................
m ...................................
m ...................................
m ...................................
m ...................................
m ...................................
m ...................................
m .................$.................
m ...................................
m ...................................
m ...................................
m ...................................
m ...................................
m ...................................
m ...................................
m ...................................
m .b............................$....
m ...................................
m ..b................................
m .b..b..............................
m ...................................