rows 37
cols 37
players 2
island $ 0 1 15
island $ 0 1 15 
island $ 0 2 20
island $ 0 1 15
island $ 0 1 15

m .....................................
m .....................................
m .....................................
m .....................................
m .....................................
m .....................................
m ....$...........................$....
m .....................................
m .....................................
m ..........b...............b..........
m .....................................
m .....................................
m .....................................
m ..................a..................
m .....................................
m ............a...........a............
m .....................................
m ..................$..................
m .....................................
m .......b.....................b.......
m ...............a.....a...............
m .....................................
m .....................................
m .....................................
m .....................................
m ..................b..................
m .....................................
m .....................................
m ....$...........................$....
m .....................................
m .....................................
m .....................................
m .....................................
m .....................................
m .....................................
m .....................................
m .....................................








































