rows 41
cols 41
players 2
island $ 0 2 45
island $ 0 2 45
island $ 0
island $ 0
island $ 0
island $ 0
island $ 0
zone 0 rect -10 0 -1 9
zone 1 rect 0 -10 9 -1

m .........................................
m ..................................bbb..b.
m .........................................
m .....$...................................
m ....$..................................b.
m .......................................b.
m .......................................b.
m .........................................
m .........................................
m .........................................
m .........................................
m .........................................
m .........................................
m .........................................
m .........................................
m .........................................
m .........................................
m .........................................
m .........................................
m .........................................
m .........................................
m .........................................
m .........................................
m .........................................
m .........................................
m .........................................
m .........................................
m .........................................
m .........................................
m .........................................
m .........................................
m .......................................$.
m .........................................
m .........................................
m .a....................................$..
m .a.......................................
m .a.......................................
m .........................................
m ...................................$.....
m .a..aaa.........................$........
m .........................................
