rows 37
cols 37
players 2
island a 0 2 20
island $ 0 1 30
island b 0 2 20
#zone 0 rect -10 0 -1 9
#zone 1 rect 0 -10 9 -1
maxpoints 500

m .....................................
m .....................b...............
m ............b........................
m .....................................
m .....................................
m ....a...........................b....
m .....................................
m .....................................
m .........b...........................
m ......................$..............
m .....................................
m .....................................
m .....................................
m .....................................
m .....................................
m .....................................
m .............b.......................
m .....................................
m .a................$................b.
m .....................................
m .......................a.............
m .....................................
m .....................................
m .....................................
m .....................................
m .....................................
m .....................................
m ...............$.....................
m ...........................a.........
m .....................................
m .....................................
m ....a...........................b....
m .....................................
m .....................................
m ........................a............
m ...............a.....................
m .....................................